R 10000 10000
NO ./textures/nba1.xpm
SO ./textures/nba2.xpm
WE ./textures/nba3.xpm
EA ./textures/nba4.xpm
S ./textures/barrel.xpm
F 153,0,0
C 76,0,153

 111111111111111111111111111111111
1000000000110000000000000000111111
10110000011100022222222010011
101200000000000000000W0010001111111
10110000011100000000000010001          111
10000000001100000111011110001          1201
11110111111111011101010000001           1111
11000000110101011000000000001
10002000000000000000000000001111
10000000000000001101010010001
11000000110101011111011110001
1111011111110101111101111000111111
11111111111111111111111111111
111111111111        111111111
11111111111111111111111111111






