R 1080 720
NO ./textures/nba1.xpm
SO ./textures/nba2.xpm
WE ./textures/nba3.xpm
EA ./textures/nba4.xpm

S ./textures/barrel.xpm
F 139,0,0
C 0,205,205

111111111
11N2221
1111111


11111
100W1111
11101
1111111111

